XXXXXXXXXXXX
X*   X$    X
X    XXX   X
X          X
XXXXXXXXXXXX